anoCar2	Anolis.carolinensis	Lizard
bosTau6	Bos.taurus	Cow
calJac3	Callithrix.jacchus	Marmoset
canFam2	Canis.familiaris	Dog
cavPor3	Cavia.porcellus	Guinea Pig
choHof1	Choloepus.hoffmanni	Sloth
danRer7	Danio.rerio	Zebrafish
dasNov2	Dasypus.novemcinctus	Armadillo
dipOrd1	Dipodomys.ordii	Kangaroo Rat
echTel1	Echinops.telfairi	Tenrec
equCab2	Equus.caballus	Horse
eriEur1	Erinaceus.europaeus	Hedgehog
felCat3	Felis.catus	Cat
fr2	Takifugu.rubripes	Fugu
galGal3	Gallus.gallus	Chicken
gasAcu1	Gasterosteus.aculeatus	Stickleback
gorGor1	Gorilla.gorilla	Gorilla
hg19	Homo.sapiens	Human
loxAfr3	Loxodonta.africana	Elephant
macEug1	Macropus.eugenii	Wallaby
micMur1	Microcebus.murinus	Mouse Lemur
mm9	Mus.musculus	Mouse
monDom5	Monodelphis.domestica	Opossum
myoLuc1	Myotis.lucifugus	Microbat
ochPri2	Ochotona.princeps	Pika
ornAna1	Ornithorhynchus.anatinus	Platypus
oryCun2	Oryctolagus.cuniculus	Rabbit
oryLat2	Oryzias.latipes	Medaka
otoGar1	Otolemur.garnettii	Bushbaby
panTro3	Pan.troglodytes	Chimp
ponAbe2	Pongo.abelii	Orangutan	#Pongo.abelii/pygmaeus
proCap1	Procavia.capensis	Rock Hyrax
pteVam1	Pteropus.vampyrus	Megabat
rheMac2	Macaca.mulatta	Rhesus
rn4	Rattus.norvegicus	Rat
sorAra1	Sorex.araneus	Shrew
speTri1	Spermophilus.tridecemlineatus	Squirrel
taeGut1	Taeniopygia.guttata	Zebra Finch
tarSyr1	Tarsius.syrichta	Tarsier
tetNig2	Tetraodon.nigroviridis	Tetraodon
tupBel1	Tupaia.belangeri	Tree Shrew
turTru1	Tursiops.truncatus	Dolphin
vicPac1	Vicugna.pacos	Alpaca
xenTro3	Xenopus.tropicalis	Xenopus
